06,00,24,24,24,24,24,24,24,24,24,24,24,24,24,24,24,24,24,24,24,24,24,24,08,
04,17,23,23,23,23,23,23,23,23,23,23,23,23,23,23,23,23,23,23,23,23,23,15,03,
04,00,19,25,20,00,19,25,25,25,20,00,19,25,25,25,25,25,25,25,25,25,20,00,03,
04,00,03,06,12,00,11,02,02,08,04,00,03,06,02,08,06,02,08,06,02,08,04,00,03,
04,00,03,04,00,00,00,00,00,03,04,00,03,04,00,03,04,00,00,00,00,03,04,00,03,
04,00,03,04,00,09,01,10,00,03,04,00,03,04,00,03,05,01,07,04,00,03,04,00,03,
04,00,03,04,00,11,02,12,00,03,04,00,03,04,00,03,06,02,02,12,00,03,04,00,03,
04,00,03,04,00,00,00,00,00,03,04,00,03,04,00,00,00,00,00,00,00,03,04,00,03,
04,00,03,05,01,01,01,01,01,07,05,00,07,05,01,07,05,01,01,01,00,07,04,00,03,
04,00,21,24,24,24,24,24,24,24,24,00,24,24,24,24,24,24,24,24,00,24,22,00,03,
04,17,23,23,23,23,23,23,23,23,23,13,23,23,23,23,23,23,23,23,16,23,23,14,03,
04,00,19,25,25,25,25,25,25,25,20,00,19,25,25,25,25,25,25,25,25,25,20,00,03,
04,00,03,06,02,02,02,02,02,08,04,00,03,28,28,28,28,28,28,28,28,28,04,00,03,
04,00,03,04,00,00,00,00,00,03,04,00,03,06,02,08,06,02,08,28,28,28,04,00,03,
04,00,03,04,00,00,00,00,00,03,04,17,23,23,14,03,04,00,03,28,28,28,04,00,03,
04,00,03,04,00,00,00,00,17,23,23,14,03,05,01,07,04,00,03,28,28,28,04,00,03,
04,00,03,05,01,01,01,01,01,07,04,00,03,06,02,02,12,00,03,28,28,28,04,00,03,
04,00,03,28,28,28,28,06,02,08,04,00,03,04,00,00,00,00,03,28,28,28,04,00,03,
04,00,03,28,28,28,28,04,17,23,23,13,23,23,14,00,00,00,03,28,28,28,04,00,03,
04,00,03,28,28,28,28,05,01,07,04,00,03,04,00,00,00,00,03,28,28,28,04,00,03,
04,00,03,28,28,28,28,28,28,28,04,00,03,04,00,00,00,00,03,28,28,28,04,00,03,
04,00,03,28,28,28,28,28,28,28,05,01,07,05,01,01,01,01,07,28,28,28,04,00,03,
04,00,21,24,24,24,24,24,24,24,24,24,24,24,24,24,24,24,24,24,24,24,22,00,03,
04,18,23,23,23,23,23,23,23,23,23,23,23,23,23,23,23,23,23,23,23,23,23,14,03,
05,25,25,25,25,25,25,25,25,25,25,25,25,25,25,25,25,25,25,25,25,25,25,00,07,

1,1,1,1,1,1,1,1,1,1,1,1,1,1,1,1,1,1,1,1,1,1,1,1,1,
1,0,0,0,0,0,0,0,0,0,0,0,0,0,0,0,0,0,0,0,0,0,0,0,1,
1,0,1,1,1,0,1,1,1,1,1,0,1,1,1,1,1,1,1,1,1,1,1,0,1,
1,0,1,1,1,0,1,1,1,1,1,0,1,1,1,1,1,1,1,1,1,1,1,0,1,
1,0,1,1,0,0,0,0,0,1,1,0,1,1,0,1,1,0,0,0,0,1,1,0,1,
1,0,1,1,0,1,1,1,0,1,1,0,1,1,0,1,1,1,1,1,0,1,1,0,1,
1,0,1,1,0,1,1,1,0,1,1,0,1,1,0,1,1,1,1,1,0,1,1,0,1,
1,0,1,1,0,0,0,0,0,1,1,0,1,1,0,0,0,0,0,0,0,1,1,0,1,
1,0,1,1,1,1,1,1,1,1,1,0,1,1,1,1,1,1,1,1,0,1,1,0,1,
1,0,1,1,1,1,1,1,1,1,1,0,1,1,1,1,1,1,1,1,0,1,1,0,1,
1,0,0,0,0,0,0,0,0,0,0,0,0,0,0,0,0,0,0,0,0,0,0,0,1,
1,0,1,1,1,1,1,1,1,1,1,0,1,1,1,1,1,1,1,1,1,1,1,0,1,
1,0,1,1,1,1,1,1,1,1,1,0,1,0,0,0,0,0,0,0,0,0,1,0,1,
1,0,1,1,0,0,0,0,0,1,1,0,1,1,1,1,1,1,1,0,0,0,1,0,1,
1,0,1,1,0,0,0,0,0,1,1,0,0,0,0,1,0,0,1,0,0,0,1,0,1,
1,0,1,1,0,0,0,0,0,0,0,0,1,1,1,1,1,0,1,0,0,0,1,0,1,
1,0,1,1,1,1,1,1,1,1,1,0,1,1,1,1,1,0,1,0,0,0,1,0,1,
1,0,1,0,0,0,0,1,1,1,1,0,1,1,0,0,0,0,1,0,0,0,1,0,1,
1,0,1,0,0,0,0,1,0,0,0,0,0,0,0,0,0,0,1,0,0,0,1,0,1,
1,0,1,0,0,0,0,1,1,1,1,0,1,1,0,0,0,0,1,0,0,0,1,0,1,
1,0,1,0,0,0,0,0,0,0,1,0,1,1,0,0,0,0,1,0,0,0,1,0,1,
1,0,1,0,0,0,0,0,0,0,1,1,1,1,1,1,1,1,1,0,0,0,1,0,1,
1,0,1,1,1,1,1,1,1,1,1,1,1,1,1,1,1,1,1,1,1,1,1,0,1,
1,0,0,0,0,0,0,0,0,0,0,0,0,0,0,0,0,0,0,0,0,0,0,0,1,
1,1,1,1,1,1,1,1,1,1,1,1,1,1,1,1,1,1,1,1,1,1,1,1,1,

