19,19,04,00,03,19,19,06,02,08,
19,19,04,00,03,19,19,04,00,03,
15,15,13,00,12,15,15,13,00,12,
14,14,14,09,14,14,14,14,09,14,
16,16,11,00,10,16,16,11,00,10,
19,19,04,00,03,06,02,13,00,03,
19,19,04,00,03,04,00,00,00,03,
19,19,04,00,03,04,00,00,00,03,
19,19,04,00,03,04,00,00,00,03,
19,19,04,00,03,05,01,01,01,07,

0,0,1,0,1,0,0,1,1,1,
0,0,1,0,1,0,0,1,0,1,
1,1,1,0,1,1,1,1,0,1,
0,0,0,0,0,0,0,0,0,0,
1,1,1,0,1,1,1,1,0,1,
0,0,1,0,1,1,1,1,0,1,
0,0,1,0,1,1,0,0,0,1,
0,0,1,0,1,1,0,0,0,1,
0,0,1,0,1,1,0,0,0,1,
0,0,1,0,1,1,1,1,1,1,


