tileswide 10
tileshigh 10
tilewidth 32
tileheight 32

layer 0
19,19,4,0,3,19,19,6,2,8,
19,19,4,0,3,19,19,4,0,3,
15,15,13,0,12,15,15,13,0,12,
14,14,14,9,14,14,14,14,9,14,
16,16,11,0,10,16,16,11,0,10,
19,19,4,0,3,6,2,13,0,3,
19,19,4,0,3,4,0,0,0,3,
19,19,4,0,3,4,0,0,0,3,
19,19,4,0,3,4,0,0,0,3,
19,19,4,0,3,5,1,1,1,7,

